0,0,0,0,0,0,0,0,0,0
0,2,2,2,4,0,0,0,0,0
0,2,5,1,1,4,0,0,0,0
0,2,1,6,1,3,3,0,0,0
0,4,1,1,1,1,3,4,0,0
0,0,4,3,1,1,1,1,4,0
0,0,0,3,3,1,7,1,2,0
0,0,0,0,4,1,1,5,2,0
0,0,0,0,0,4,2,2,2,0
0,0,0,0,0,0,0,0,0,0